,Cabinet,Dept,Program   ,Expense Category,FY20 Actual Expense,FY21 Actual Expense,FY22 Appropriation,FY23 Adopted,Total
0,Mayors Cabinet,Mayor's Office,Mayor's Administration,Personnel Services,1887992,1820538,1760179,1584054,7052763
1,Mayors Cabinet,Mayor's Office,Mayor's Administration,Contractual Services,111577,127558,99314,99314,437763
2,Mayors Cabinet,Mayor's Office,Mayor's Administration,Supplies & Materials,55384,27318,44938,44938,172578
3,Mayors Cabinet,Mayor's Office,Mayor's Administration,Current Charges & Obligations,12782,11366,29630,29630,83408
4,Mayors Cabinet,Mayor's Office,Mayor's Administration,Equipment,21629,39041,24900,24900,110470
5,Mayors Cabinet,Mayor's Office,Mayor's Executive,Personnel Services,441266,403120,455771,377948,1678105
6,Mayors Cabinet,Mayor's Office,Mayor's Executive,Contractual Services,0,-25,0,0,-25
7,Mayors Cabinet,Mayor's Office,Mayor's Policy & Planning,Personnel Services,1515285,1603125,1323898,1916580,6358888
8,Mayors Cabinet,Mayor's Office,Mayor's Policy & Planning,Contractual Services,133467,207821,389079,389079,1119446
9,Mayors Cabinet,Mayor's Office,New Urban Mechanics,Personnel Services,347067,416899,487357,604730,1856053
10,Mayors Cabinet,Mayor's Office,New Urban Mechanics,Contractual Services,34367,16083,28800,28800,108050
11,Mayors Cabinet,Mayor's Office,New Urban Mechanics,Supplies & Materials,2526,2187,5961,5961,16635
12,Mayors Cabinet,Mayor's Office,New Urban Mechanics,Current Charges & Obligations,721,5857,6400,6400,19378
13,Mayors Cabinet,Mayor's Office,New Urban Mechanics,Equipment,172,34717,100,100,35089
14,Mayors Cabinet,Mayor's Office,Mayor's Communications,Personnel Services,510181,708665,767254,1028638,3014738
15,Mayors Cabinet,Mayor's Office,Mayor's Communications,Contractual Services,38880,295,0,0,39175
16,Mayors Cabinet,Mayor's Office,Mayor's Communications,Current Charges & Obligations,382,0,7038,7038,14458
17,Mayors Cabinet,Election Department,Election Administration,Personnel Services,592068,654702,704139,745758,2696667
18,Mayors Cabinet,Election Department,Election Administration,Contractual Services,130318,157387,118950,125660,532315
19,Mayors Cabinet,Election Department,Election Administration,Supplies & Materials,41961,81519,50818,55056,229354
20,Mayors Cabinet,Election Department,Election Administration,Current Charges & Obligations,0,912,3200,3200,7312
21,Mayors Cabinet,Election Department,Election Administration,Equipment,336795,330520,359053,386676,1413044
22,Mayors Cabinet,Election Department,Voter Registration,Personnel Services,386259,320187,411058,365577,1483081
23,Mayors Cabinet,Election Department,Voter Registration,Contractual Services,516,304,600,600,2020
24,Mayors Cabinet,Election Department,Voter Registration,Supplies & Materials,26775,78618,25500,25500,156393
25,Mayors Cabinet,Election Department,Election Activities,Personnel Services,1916559,2064304,2176966,2445298,8603127
26,Mayors Cabinet,Election Department,Election Activities,Contractual Services,366882,299215,778900,565900,2010897
27,Mayors Cabinet,Election Department,Election Activities,Supplies & Materials,212011,185343,926500,1183800,2507654
28,Mayors Cabinet,Election Department,Election Activities,Current Charges & Obligations,105623,103795,155500,155500,520418
29,Mayors Cabinet,Election Department,Election Activities,Equipment,0,12657,0,30000,42657
30,Mayors Cabinet,Listing Board,Annual Listing,Personnel Services,298415,260843,360916,404066,1324240
31,Mayors Cabinet,Listing Board,Annual Listing,Contractual Services,26943,11585,36550,51897,126975
32,Mayors Cabinet,Listing Board,Annual Listing,Supplies & Materials,206775,223618,241350,270000,941743
33,Mayors Cabinet,Intergovernmental Relations,IGR,Personnel Services,826923,807261,916422,1045363,3595969
34,Mayors Cabinet,Intergovernmental Relations,IGR,Contractual Services,246676,171102,187299,192299,797376
35,Mayors Cabinet,Intergovernmental Relations,IGR,Supplies & Materials,51361,2329,6200,6200,66090
36,Mayors Cabinet,Intergovernmental Relations,IGR,Current Charges & Obligations,189473,191807,192717,192717,766714
37,Mayors Cabinet,Intergovernmental Relations,Grants Administration,Personnel Services,108206,109716,111873,113457,443252
38,Mayors Cabinet,Intergovernmental Relations,Grants Administration,Contractual Services,234,-25,0,0,209
39,Mayors Cabinet,Intergovernmental Relations,Grants Administration,Current Charges & Obligations,330,330,330,330,1320
40,Mayors Cabinet,Law Department,Law Operations,Personnel Services,1111480,939653,1011617,1244985,4307735
41,Mayors Cabinet,Law Department,Law Operations,Contractual Services,495235,246144,361225,369425,1472029
42,Mayors Cabinet,Law Department,Law Operations,Supplies & Materials,14208,10528,13975,16375,55086
43,Mayors Cabinet,Law Department,Law Operations,Current Charges & Obligations,53253,61167,35635,33000,183055
44,Mayors Cabinet,Law Department,Law Operations,Equipment,73150,0,0,4228,77378
45,Mayors Cabinet,Law Department,Litigation,Personnel Services,902263,1165592,1231040,1504899,4803794
46,Mayors Cabinet,Law Department,Litigation,Contractual Services,1853713,1900051,1589225,1665800,7008789
47,Mayors Cabinet,Law Department,Litigation,Supplies & Materials,0,52,2000,2000,4052
48,Mayors Cabinet,Law Department,Litigation,Current Charges & Obligations,79896,28207,39809,37000,184912
49,Mayors Cabinet,Law Department,Government Services,Personnel Services,3048373,3107261,3698055,4682448,14536137
50,Mayors Cabinet,Law Department,Government Services,Contractual Services,38859,20822,169755,150700,380136
51,Mayors Cabinet,Law Department,Government Services,Supplies & Materials,1256,728,1000,2000,4984
52,Mayors Cabinet,Law Department,Government Services,Current Charges & Obligations,25163,22750,82867,60500,191280
53,Equity & Inclusion Cabinet,Office of Equity,Equity,Personnel Services,0,0,522522,1236554,1759076
54,Equity & Inclusion Cabinet,Office of Equity,Equity,Contractual Services,0,0,4460,106620,111080
55,Equity & Inclusion Cabinet,Office of Equity,Equity,Supplies & Materials,0,0,1000,10500,11500
56,Equity & Inclusion Cabinet,Office of Equity,Equity,Current Charges & Obligations,0,0,1500,11000,12500
57,Equity & Inclusion Cabinet,Office of Equity,Equity,Equipment,0,0,0,6000,6000
58,Equity & Inclusion Cabinet,Office of Equity,Equity & Inclusion,Personnel Services,0,0,2320448,0,2320448
59,Equity & Inclusion Cabinet,Office of Equity,Equity & Inclusion,Contractual Services,0,0,1491674,0,1491674
60,Equity & Inclusion Cabinet,Office of Equity,Equity & Inclusion,Supplies & Materials,0,0,3730,0,3730
61,Equity & Inclusion Cabinet,Office of Equity,Equity & Inclusion,Current Charges & Obligations,0,0,1000,0,1000
62,Equity & Inclusion Cabinet,Office of Diversity,Diversity,Personnel Services,0,0,254633,0,254633
63,Equity & Inclusion Cabinet,Office of Diversity,Diversity,Contractual Services,0,0,92160,0,92160
64,Equity & Inclusion Cabinet,Office of Diversity,Diversity,Supplies & Materials,0,0,7874,0,7874
65,Equity & Inclusion Cabinet,Office of Resiliency & Racial Equity,MORRE,Personnel Services,0,0,275287,284316,559603
66,Equity & Inclusion Cabinet,Office of Resiliency & Racial Equity,MORRE,Contractual Services,0,0,1375700,842160,2217860
67,Equity & Inclusion Cabinet,Office of Resiliency & Racial Equity,MORRE,Supplies & Materials,0,0,250,250,500
68,Equity & Inclusion Cabinet,Office of Resiliency & Racial Equity,MORRE,Current Charges & Obligations,0,0,155,155,310
69,Equity & Inclusion Cabinet,Office of Language & Communications Access,LCA,Personnel Services,0,0,269382,748081,1017463
70,Equity & Inclusion Cabinet,Office of Language & Communications Access,LCA,Contractual Services,0,0,897585,1048551,1946136
71,Equity & Inclusion Cabinet,Office of Language & Communications Access,LCA,Supplies & Materials,0,0,3000,1936,4936
72,Equity & Inclusion Cabinet,Office of Language & Communications Access,LCA,Current Charges & Obligations,0,0,0,5670,5670
73,Equity & Inclusion Cabinet,Office of Language & Communications Access,LCA,Equipment,0,0,0,44428,44428
74,Equity & Inclusion Cabinet,Human Right Commission,Human Rights,Personnel Services,0,182642,455452,484546,1122640
75,Equity & Inclusion Cabinet,Human Right Commission,Human Rights,Contractual Services,0,11170,135400,134500,281070
76,Equity & Inclusion Cabinet,Human Right Commission,Human Rights,Supplies & Materials,0,0,1000,1000,2000
77,Equity & Inclusion Cabinet,Human Right Commission,Human Rights,Current Charges & Obligations,0,1016,11000,11000,23016
78,Equity & Inclusion Cabinet,Office for Immigrant Advancement,Immigrant Advancement,Personnel Services,471398,688559,838138,966446,2964541
79,Equity & Inclusion Cabinet,Office for Immigrant Advancement,Immigrant Advancement,Contractual Services,178266,420389,852280,2115085,3566020
80,Equity & Inclusion Cabinet,Office for Immigrant Advancement,Immigrant Advancement,Supplies & Materials,5304,5532,11500,11500,33836
81,Equity & Inclusion Cabinet,Office for Immigrant Advancement,Immigrant Advancement,Current Charges & Obligations,5099,924,2800,16324,25147
82,Equity & Inclusion Cabinet,Office for Immigrant Advancement,Immigrant Advancement,Equipment,12738,5760,0,0,18498
83,Equity & Inclusion Cabinet,Women's Advancement,Women's Commission Program,Personnel Services,276763,309482,359184,340272,1285701
84,Equity & Inclusion Cabinet,Women's Advancement,Women's Commission Program,Contractual Services,62280,156872,509373,134573,863098
85,Equity & Inclusion Cabinet,Women's Advancement,Women's Commission Program,Supplies & Materials,7,0,800,800,1607
86,Equity & Inclusion Cabinet,Women's Advancement,Women's Commission Program,Current Charges & Obligations,140,0,140,140,420
87,Equity & Inclusion Cabinet,Women's Advancement,Women's Commission Program,Equipment,575,0,0,0,575
88,Equity & Inclusion Cabinet,Black Male Advancement,BMA,Personnel Services,0,0,0,1054418,1054418
89,Equity & Inclusion Cabinet,Black Male Advancement,BMA,Contractual Services,0,0,0,726550,726550
90,Equity & Inclusion Cabinet,Black Male Advancement,BMA,Supplies & Materials,0,0,0,10500,10500
91,Equity & Inclusion Cabinet,Black Male Advancement,BMA,Current Charges & Obligations,0,0,0,2800,2800
92,Equity & Inclusion Cabinet,Black Male Advancement,BMA,Equipment,0,0,0,9500,9500
93,Equity & Inclusion Cabinet,Fair Housing & Equity,Fair Housing Commission,Personnel Services,130809,179181,490302,406034,1206326
94,Equity & Inclusion Cabinet,Fair Housing & Equity,Fair Housing Commission,Contractual Services,10517,7476,13240,113240,144473
95,Equity & Inclusion Cabinet,Fair Housing & Equity,Fair Housing Commission,Supplies & Materials,11678,3061,11822,11822,38383
96,Equity & Inclusion Cabinet,Fair Housing & Equity,Fair Housing Commission,Current Charges & Obligations,4301,590,2150,2150,9191
97,Equity & Inclusion Cabinet,Fair Housing & Equity,Fair Housing Commission,Equipment,0,1700,0,0,1700
98,Equity & Inclusion Cabinet,Fair Housing & Equity,Human Rights History,Personnel Services,69625,0,0,0,69625
99,Equity & Inclusion Cabinet,LGBTQ+ Advancement,LGBTQ+ Admin,Personnel Services,0,0,0,220000,220000
100,Equity & Inclusion Cabinet,LGBTQ+ Advancement,LGBTQ+ Admin,Contractual Services,0,0,0,202250,202250
101,Equity & Inclusion Cabinet,LGBTQ+ Advancement,LGBTQ+ Admin,Supplies & Materials,0,0,0,15000,15000
102,Equity & Inclusion Cabinet,LGBTQ+ Advancement,LGBTQ+ Admin,Current Charges & Obligations,0,0,0,2750,2750
103,Equity & Inclusion Cabinet,LGBTQ+ Advancement,LGBTQ+ Admin,Equipment,0,0,0,5000,5000
104,Equity & Inclusion Cabinet,Commission For Persons W/Disabilities,Disabilities,Personnel Services,465517,474251,504316,659933,2104017
105,Equity & Inclusion Cabinet,Commission For Persons W/Disabilities,Disabilities,Contractual Services,13112,4993,112620,21150,151875
106,Equity & Inclusion Cabinet,Commission For Persons W/Disabilities,Disabilities,Supplies & Materials,4625,4757,7000,7000,23382
107,Equity & Inclusion Cabinet,Commission For Persons W/Disabilities,Disabilities,Equipment,0,880,0,0,880
108,OPAT Cabinet,Office of Police Accountability & Transparency,OPAT Commission,Personnel Services,0,0,1097500,1089213,2186713
109,OPAT Cabinet,Office of Police Accountability & Transparency,OPAT Commission,Contractual Services,0,0,5000,99460,104460
110,OPAT Cabinet,Office of Police Accountability & Transparency,OPAT Commission,Supplies & Materials,0,0,7000,20000,27000
111,OPAT Cabinet,Office of Police Accountability & Transparency,OPAT Commission,Current Charges & Obligations,0,0,0,98871,98871
112,OPAT Cabinet,Office of Police Accountability & Transparency,OPAT Commission,Equipment,0,0,6000,6000,12000
113,OPAT Cabinet,Office of Police Accountability & Transparency,Civilian Review Board (CRB),Personnel Services,0,0,50000,50000,100000
114,OPAT Cabinet,Office of Police Accountability & Transparency,Civilian Review Board (CRB),Contractual Services,0,0,4000,0,4000
115,OPAT Cabinet,Office of Police Accountability & Transparency,Civilian Review Board (CRB),Supplies & Materials,0,0,1000,0,1000
116,OPAT Cabinet,Office of Police Accountability & Transparency,Internal Affairs Oversight Panel (IOAP),Personnel Services,0,0,125000,125000,250000
117,OPAT Cabinet,Office of Police Accountability & Transparency,Internal Affairs Oversight Panel (IOAP),Contractual Services,0,0,4000,0,4000
118,OPAT Cabinet,Office of Police Accountability & Transparency,Internal Affairs Oversight Panel (IOAP),Supplies & Materials,0,0,1000,0,1000
119,Operations,Property Management Department,PM Administration,Personnel Services,1732549,1806599,3212928,1917832,8669908
120,Operations,Property Management Department,PM Administration,Contractual Services,110185,82967,111598,111598,416348
121,Operations,Property Management Department,PM Administration,Supplies & Materials,21708,15995,22560,15861,76124
122,Operations,Property Management Department,PM Administration,Current Charges & Obligations,48626,85868,104040,109440,347974
123,Operations,Property Management Department,Building Operations,Personnel Services,1898590,1673554,1599935,2383650,7555729
124,Operations,Property Management Department,Building Operations,Contractual Services,5835484,5472361,5889387,6525432,23722664
125,Operations,Property Management Department,Building Operations,Supplies & Materials,203272,90203,662625,162625,1118725
126,Operations,Property Management Department,Building Operations,Current Charges & Obligations,6608,6374,10025,41094,64101
127,Operations,Property Management Department,Building Operations,Equipment,142486,45806,28127,104225,320644
128,Operations,Property Management Department,Alterations & Repair,Personnel Services,742907,504369,635640,709952,2592868
129,Operations,Property Management Department,Alterations & Repair,Contractual Services,2419527,3861197,888582,1436905,8606211
130,Operations,Property Management Department,Alterations & Repair,Supplies & Materials,154275,46456,69965,69965,340661
131,Operations,Property Management Department,Alterations & Repair,Equipment,198402,570761,0,0,769163
132,Operations,Property Management Department,Enforcement,Personnel Services,2891963,2479754,1333015,2593463,9298195
133,Operations,Property Management Department,Enforcement,Contractual Services,83193,95733,92459,94918,366303
134,Operations,Property Management Department,Enforcement,Supplies & Materials,81796,124976,90271,80501,377544
135,Operations,Property Management Department,Enforcement,Current Charges & Obligations,7361,8657,8000,8000,32018
136,Operations,Property Management Department,Enforcement,Equipment,3919,37,35627,40072,79655
137,Operations,Property Management Department,Security Systems,Personnel Services,710978,667934,665317,706928,2751157
138,Operations,Property Management Department,Security Systems,Contractual Services,5620,9449,15586,15586,46241
139,Operations,Property Management Department,Security Systems,Supplies & Materials,17117,6076,20130,20130,63453
140,Operations,Property Management Department,Security Systems,Current Charges & Obligations,4,1914,900,900,3718
141,Operations,Property Management Department,Security Systems,Equipment,22696,11104,7000,20636,61436
142,Operations,Property Management Department,Building Systems,Personnel Services,793369,564903,755310,801142,2914724
143,Operations,Property Management Department,Building Systems,Contractual Services,1795585,1101132,1488385,1605650,5990752
144,Operations,Property Management Department,Building Systems,Supplies & Materials,56253,33466,54500,54500,198719
145,Operations,Property Management Department,Building Systems,Current Charges & Obligations,1400,1350,2500,2500,7750
146,Operations,Property Management Department,Building Systems,Equipment,2005,970,3000,3000,8975
147,Operations,Public Facilities Department,PFD Capital Construction,Personnel Services,6279941,6809366,7524063,8297445,28910815
148,Operations,Public Facilities Department,PFD Capital Construction,Contractual Services,326305,332634,114520,470260,1243719
149,Operations,Public Facilities Department,PFD Capital Construction,Supplies & Materials,23806,9799,26444,27012,87061
150,Operations,Public Facilities Department,PFD Capital Construction,Current Charges & Obligations,14089,11159,27200,21700,74148
151,Operations,Public Facilities Department,PFD Capital Construction,Equipment,0,0,5800,5800,11600
152,Operations,Inspectional Services Department,ISD Commissioner's Office,Personnel Services,784045,843404,1116119,993801,3737369
153,Operations,Inspectional Services Department,ISD Commissioner's Office,Contractual Services,466505,394930,451658,277751,1590844
154,Operations,Inspectional Services Department,ISD Commissioner's Office,Supplies & Materials,3954,6514,8459,1270,20197
155,Operations,Inspectional Services Department,ISD Commissioner's Office,Current Charges & Obligations,10770,37268,32654,63018,143710
156,Operations,Inspectional Services Department,ISD Commissioner's Office,Equipment,5353,0,2489,2453,10295
157,Operations,Inspectional Services Department,ISD Administration & Finance,Personnel Services,1816116,2205104,2501083,2924590,9446893
158,Operations,Inspectional Services Department,ISD Administration & Finance,Contractual Services,395301,221098,456707,580151,1653257
159,Operations,Inspectional Services Department,ISD Administration & Finance,Supplies & Materials,192336,167012,198628,196377,754353
160,Operations,Inspectional Services Department,ISD Administration & Finance,Current Charges & Obligations,665427,828722,985875,703240,3183264
161,Operations,Inspectional Services Department,ISD Administration & Finance,Equipment,222307,31989,10000,22272,286568
162,Operations,Inspectional Services Department,Buildings & Structures,Personnel Services,6552997,7598633,8476301,8593956,31221887
163,Operations,Inspectional Services Department,Buildings & Structures,Contractual Services,414745,508606,306995,299206,1529552
164,Operations,Inspectional Services Department,Buildings & Structures,Supplies & Materials,36210,25790,17204,32210,111414
165,Operations,Inspectional Services Department,Buildings & Structures,Current Charges & Obligations,14307,7530,608,98326,120771
166,Operations,Inspectional Services Department,Buildings & Structures,Equipment,17258,17088,14779,8512,57637
167,Operations,Inspectional Services Department,Field Services,Personnel Services,6614700,6720592,7603839,7716197,28655328
168,Operations,Inspectional Services Department,Field Services,Contractual Services,247560,225894,280489,297241,1051184
169,Operations,Inspectional Services Department,Field Services,Supplies & Materials,37471,39244,36065,34450,147230
170,Operations,Inspectional Services Department,Field Services,Current Charges & Obligations,3004,2760,7029,5550,18343
171,Operations,Inspectional Services Department,Field Services,Equipment,21130,17197,40948,35505,114780
172,Community Engagement,Neighborhood Services,ONS Administration,Personnel Services,516408,640264,777674,934963,2869309
173,Community Engagement,Neighborhood Services,ONS Administration,Contractual Services,155281,59937,46100,46100,307418
174,Community Engagement,Neighborhood Services,ONS Administration,Supplies & Materials,4840,2969,6731,7189,21729
175,Community Engagement,Neighborhood Services,ONS Administration,Current Charges & Obligations,8440,20028,7664,2430,38562
176,Community Engagement,Neighborhood Services,Neighborhood Serv,Personnel Services,1296455,1293366,1427094,1599393,5616308
177,Community Engagement,Neighborhood Services,Neighborhood Serv,Contractual Services,-1525,-825,110200,10200,118050
178,Community Engagement,Neighborhood Services,Neighborhood Serv,Supplies & Materials,3914,1047,3800,3800,12561
179,Community Engagement,Neighborhood Services,Office of Civic Organizing,Personnel Services,67435,87221,105387,74950,334993
180,Community Engagement,Neighborhood Services,Office of Civic Organizing,Contractual Services,9486,20856,1090,1090,32522
181,Community Engagement,Neighborhood Services,Office of Civic Organizing,Supplies & Materials,401,556,500,500,1957
182,Community Engagement,Neighborhood Services,Office of Civic Organizing,Equipment,0,3270,0,0,3270
183,Community Engagement,Neighborhood Services,Boston 311,Personnel Services,1279725,1465349,1632308,1967746,6345128
184,Community Engagement,Neighborhood Services,Boston 311,Contractual Services,349669,426363,7000,7000,790032
185,Community Engagement,Neighborhood Services,Boston 311,Supplies & Materials,453,142,2700,2700,5995
186,Community Engagement,Neighborhood Services,Boston 311,Current Charges & Obligations,0,0,776,776,1552
187,Community Engagement,Neighborhood Services,Boston 311,Equipment,1546,0,0,0,1546
188,Arts & Culture,Office of Arts & Culture,Arts and Culture,Personnel Services,1102255,1091021,1369492,1739662,5302430
189,Arts & Culture,Office of Arts & Culture,Arts and Culture,Contractual Services,920561,975980,2209432,2287943,6393916
190,Arts & Culture,Office of Arts & Culture,Arts and Culture,Supplies & Materials,7354,2400,5000,5000,19754
191,Arts & Culture,Office of Arts & Culture,Arts and Culture,Current Charges & Obligations,10201,21682,45151,45148,122182
192,Arts & Culture,Office of Arts & Culture,Arts and Culture,Equipment,8954,8366,0,0,17320
193,Economic Opportunity & Inclusion,Office of Economic Opportunity & Inclusion,Economic Development,Personnel Services,1449227,781580,1000068,1811986,5042861
194,Economic Opportunity & Inclusion,Office of Economic Opportunity & Inclusion,Economic Development,Contractual Services,101935,47344,26744,389419,565442
195,Economic Opportunity & Inclusion,Office of Economic Opportunity & Inclusion,Economic Development,Supplies & Materials,22009,1985,12000,12000,47994
196,Economic Opportunity & Inclusion,Office of Economic Opportunity & Inclusion,Economic Development,Current Charges & Obligations,38467,12990,48340,63410,163207
197,Economic Opportunity & Inclusion,Office of Economic Opportunity & Inclusion,Economic Development,Equipment,29240,30008,4200,4200,67648
198,Economic Opportunity & Inclusion,Office of Economic Opportunity & Inclusion,Equity & Inclusion History,Personnel Services,644818,1206452,0,0,1851270
199,Economic Opportunity & Inclusion,Office of Economic Opportunity & Inclusion,Equity & Inclusion History,Contractual Services,218612,1178284,0,0,1396896
200,Economic Opportunity & Inclusion,Office of Economic Opportunity & Inclusion,Equity & Inclusion History,Supplies & Materials,8729,2000,0,0,10729
201,Economic Opportunity & Inclusion,Office of Economic Opportunity & Inclusion,Equity & Inclusion History,Current Charges & Obligations,1130,28000,0,0,29130
202,Economic Opportunity & Inclusion,Office of Economic Opportunity & Inclusion,Small & Local Business,Personnel Services,605738,179371,349022,619150,1753281
203,Economic Opportunity & Inclusion,Office of Economic Opportunity & Inclusion,Small & Local Business,Contractual Services,334418,385609,1486018,3059100,5265145
204,Economic Opportunity & Inclusion,Office of Economic Opportunity & Inclusion,Small & Local Business,Supplies & Materials,3382,300,13010,12010,28702
205,Economic Opportunity & Inclusion,Office of Economic Opportunity & Inclusion,Small & Local Business,Current Charges & Obligations,5718,0,5173,2033,12924
206,Economic Opportunity & Inclusion,Consumer Affairs & Licensing,Consumer Licensing,Personnel Services,572252,569288,534583,707022,2383145
207,Economic Opportunity & Inclusion,Consumer Affairs & Licensing,Consumer Licensing,Contractual Services,3459,2015,4700,4100,14274
208,Economic Opportunity & Inclusion,Consumer Affairs & Licensing,Consumer Licensing,Supplies & Materials,2439,583,2250,2250,7522
209,Economic Opportunity & Inclusion,Consumer Affairs & Licensing,Consumer Licensing,Current Charges & Obligations,19388,3216,1680,1335,25619
210,Economic Opportunity & Inclusion,Consumer Affairs & Licensing,Consumer Licensing,Equipment,0,770,0,0,770
211,Economic Opportunity & Inclusion,Consumer Affairs & Licensing,Consumer Affairs,Personnel Services,100702,173037,110471,64656,448866
212,Economic Opportunity & Inclusion,Consumer Affairs & Licensing,Consumer Affairs,Contractual Services,60,0,200,0,260
213,Economic Opportunity & Inclusion,Consumer Affairs & Licensing,Consumer Affairs,Supplies & Materials,0,0,400,0,400
214,Economic Opportunity & Inclusion,Consumer Affairs & Licensing,Licensing_Board,Personnel Services,623980,745539,1013309,997116,3379944
215,Economic Opportunity & Inclusion,Consumer Affairs & Licensing,Licensing_Board,Contractual Services,8845,10251,109970,10590,139656
216,Economic Opportunity & Inclusion,Consumer Affairs & Licensing,Licensing_Board,Supplies & Materials,16762,7667,14750,12250,51429
217,Economic Opportunity & Inclusion,Consumer Affairs & Licensing,Licensing_Board,Current Charges & Obligations,10340,6096,10345,5430,32211
218,Economic Opportunity & Inclusion,Consumer Affairs & Licensing,Licensing_Board,Equipment,2132,0,0,0,2132
219,Economic Opportunity & Inclusion,Office of Tourism,Tourism Administration,Personnel Services,468075,486966,473919,483281,1912241
220,Economic Opportunity & Inclusion,Office of Tourism,Tourism Administration,Contractual Services,19373,16768,1031980,31980,1100101
221,Economic Opportunity & Inclusion,Office of Tourism,Tourism Administration,Supplies & Materials,13139,0,14400,14400,41939
222,Economic Opportunity & Inclusion,Office of Tourism,Tourism Administration,Current Charges & Obligations,779,2,450,450,1681
223,Economic Opportunity & Inclusion,Office of Tourism,Tourism Administration,Equipment,0,5372,0,0,5372
224,Economic Opportunity & Inclusion,Office of Tourism,Film & Special Events,Personnel Services,301488,207662,320761,308726,1138637
225,Economic Opportunity & Inclusion,Office of Tourism,Film & Special Events,Contractual Services,241718,12798,255900,330900,841316
226,Economic Opportunity & Inclusion,Office of Tourism,Film & Special Events,Supplies & Materials,706,271,849,1287,3113
227,Economic Opportunity & Inclusion,Office of Tourism,Film & Special Events,Current Charges & Obligations,55627,35394,60000,60000,211021
228,Economic Opportunity & Inclusion,Office of Tourism,Film & Special Events,Equipment,17688,463,2000,2000,22151
229,Economic Opportunity & Inclusion,Office of Tourism,Film & Special Events,Other Expenses,168301,49326,225000,225000,667627
230,Economic Opportunity & Inclusion,Office of Tourism,Tourism,Personnel Services,34920,70093,72220,78079,255312
231,Economic Opportunity & Inclusion,Office of Tourism,Tourism,Contractual Services,3452,1848,4500,4500,14300
232,Economic Opportunity & Inclusion,Office of Tourism,Tourism,Supplies & Materials,2051,1470,2500,2500,8521
233,Economic Opportunity & Inclusion,Office of Tourism,Tourism,Current Charges & Obligations,0,0,100,100,200
234,Economic Opportunity & Inclusion,Office of Tourism,Tourism,Other Expenses,37992,6337,38750,38750,121829
235,Economic Opportunity & Inclusion,Department of Supplier and Workforce Diversity,Supplier and Workforce Diversity,Personnel Services,0,0,0,2219941,2219941
236,Economic Opportunity & Inclusion,Department of Supplier and Workforce Diversity,Supplier and Workforce Diversity,Contractual Services,0,0,0,1236950,1236950
237,Economic Opportunity & Inclusion,Department of Supplier and Workforce Diversity,Supplier and Workforce Diversity,Supplies & Materials,0,0,0,10430,10430
238,Economic Opportunity & Inclusion,Department of Supplier and Workforce Diversity,Supplier and Workforce Diversity,Current Charges & Obligations,0,0,0,7198,7198
239,Economic Opportunity & Inclusion,Department of Supplier and Workforce Diversity,Supplier and Workforce Diversity,Equipment,0,0,0,4000,4000
240,Education,Boston Public Schools,Boston Public Schools,Personnel Services,947770897,997246770,1038362910,1059286547,4042667124
241,Education,Boston Public Schools,Boston Public Schools,Contractual Services,207247480,230872487,219730411,235855541,893705919
242,Education,Boston Public Schools,Boston Public Schools,Supplies & Materials,6892766,16725368,11815308,10803826,46237268
243,Education,Boston Public Schools,Boston Public Schools,Current Charges & Obligations,7348114,5903082,11215639,14480516,38947351
244,Education,Boston Public Schools,Boston Public Schools,Equipment,8488464,8890877,12783851,13777336,43940528
245,Education,Boston Public Schools,Boston Public Schools,Other Expenses,814652,826664,811742,641742,3094800
246,"Environment, Energy & Open Space",Environment Department,Environment,Personnel Services,2139826,2436307,2903178,2534392,10013703
247,"Environment, Energy & Open Space",Environment Department,Environment,Contractual Services,1022150,680823,2052033,757797,4512803
248,"Environment, Energy & Open Space",Environment Department,Environment,Supplies & Materials,38511,15663,29000,10000,93174
249,"Environment, Energy & Open Space",Environment Department,Environment,Current Charges & Obligations,1679,4887,4400,4400,15366
250,"Environment, Energy & Open Space",Environment Department,Environment,Equipment,10173,0,0,0,10173
251,"Environment, Energy & Open Space",Environment Department,Environment,Other Expenses,0,0,0,500000,500000
252,"Environment, Energy & Open Space",Parks & Recreation Department,Parks & Recreation Administration,Personnel Services,2382519,2513069,2570056,2448021,9913665
253,"Environment, Energy & Open Space",Parks & Recreation Department,Parks Operations,Personnel Services,9423925,8544588,9255605,10582352,37806470
254,"Environment, Energy & Open Space",Parks & Recreation Department,Citywide Recreation,Personnel Services,814272,756500,892541,934056,3397369
255,"Environment, Energy & Open Space",Parks & Recreation Department,Parks Design & Construction,Personnel Services,1320237,1319217,1532480,1379187,5551121
256,"Environment, Energy & Open Space",Parks & Recreation Department,Animal Care & Control,Personnel Services,1087160,1029663,1291754,1365860,4774437
257,"Environment, Energy & Open Space",Parks & Recreation Department,Parks & Recreation Administration,Contractual Services,439557,393446,537737,539737,1910477
258,"Environment, Energy & Open Space",Parks & Recreation Department,Parks Operations,Contractual Services,3667754,3957267,3809300,4432401,15866722
259,"Environment, Energy & Open Space",Parks & Recreation Department,Citywide Recreation,Contractual Services,34094,27666,286039,286039,633838
260,"Environment, Energy & Open Space",Parks & Recreation Department,Parks Design & Construction,Contractual Services,3125023,2608965,652068,706754,7092810
261,"Environment, Energy & Open Space",Parks & Recreation Department,Animal Care & Control,Contractual Services,106006,37884,253445,180445,577780
262,"Environment, Energy & Open Space",Parks & Recreation Department,Parks & Recreation Administration,Supplies & Materials,30734,32234,39050,39050,141068
263,"Environment, Energy & Open Space",Parks & Recreation Department,Parks Operations,Supplies & Materials,867563,722835,795853,855623,3241874
264,"Environment, Energy & Open Space",Parks & Recreation Department,Citywide Recreation,Supplies & Materials,47028,50916,57250,57250,212444
265,"Environment, Energy & Open Space",Parks & Recreation Department,Parks Design & Construction,Supplies & Materials,15292,74215,750,750,91007
266,"Environment, Energy & Open Space",Parks & Recreation Department,Animal Care & Control,Supplies & Materials,9506,16338,26974,91940,144758
267,"Environment, Energy & Open Space",Parks & Recreation Department,Parks & Recreation Administration,Current Charges & Obligations,390844,438215,513158,441088,1783305
268,"Environment, Energy & Open Space",Parks & Recreation Department,Parks Operations,Current Charges & Obligations,15090,60176,66465,68765,210496
269,"Environment, Energy & Open Space",Parks & Recreation Department,Citywide Recreation,Current Charges & Obligations,95657,118979,130209,100484,445329
270,"Environment, Energy & Open Space",Parks & Recreation Department,Parks Design & Construction,Current Charges & Obligations,975,0,101105,83682,185762
271,"Environment, Energy & Open Space",Parks & Recreation Department,Animal Care & Control,Current Charges & Obligations,202,202,670,10470,11544
272,"Environment, Energy & Open Space",Parks & Recreation Department,Parks & Recreation Administration,Equipment,77304,56398,79838,54036,267576
273,"Environment, Energy & Open Space",Parks & Recreation Department,Parks Operations,Equipment,719800,845316,1087778,1272937,3925831
274,"Environment, Energy & Open Space",Parks & Recreation Department,Citywide Recreation,Equipment,7272,7272,3092,0,17636
275,"Environment, Energy & Open Space",Parks & Recreation Department,Animal Care & Control,Equipment,21753,21753,27467,11494,82467
276,"Environment, Energy & Open Space",Parks & Recreation Department,Parks Operations,Other Expenses,1704760,1918620,2101268,2601268,8325916
277,"Environment, Energy & Open Space",Cemetery Division,Cemetery,Personnel Services,1778187,1953497,1999983,1993532,7725199
278,"Environment, Energy & Open Space",Cemetery Division,Cemetery,Contractual Services,239421,307090,291966,404793,1243270
279,"Environment, Energy & Open Space",Cemetery Division,Cemetery,Supplies & Materials,73034,64740,92758,97418,327950
280,"Environment, Energy & Open Space",Cemetery Division,Cemetery,Current Charges & Obligations,35783,24254,13329,21189,94555
281,"Environment, Energy & Open Space",Cemetery Division,Cemetery,Equipment,180064,168648,165993,125486,640191
282,"Environment, Energy & Open Space",Cemetery Division,Cemetery,Other Expenses,42800,36925,60000,60000,199725
283,"Environment, Energy & Open Space",Office of Historic Preservation,Historic Preservation,Personnel Services,0,0,0,1094815,1094815
284,"Environment, Energy & Open Space",Office of Historic Preservation,Historic Preservation,Contractual Services,0,0,0,182517,182517
285,"Environment, Energy & Open Space",Office of Historic Preservation,Historic Preservation,Supplies & Materials,0,0,0,19000,19000
286,"Environment, Energy & Open Space",Office of Food Justice,Food Justice,Personnel Services,0,0,0,443210,443210
287,"Environment, Energy & Open Space",Office of Food Justice,Food Justice,Contractual Services,0,0,0,913000,913000
288,"Environment, Energy & Open Space",Office of Food Justice,Food Justice,Supplies & Materials,0,0,0,2000,2000
289,"Environment, Energy & Open Space",Office of Food Justice,Food Justice,Current Charges & Obligations,0,0,0,150,150
290,Finance,Office of Finance,A&F,Personnel Services,734472,785330,873999,937900,3331701
291,Finance,Office of Finance,A&F,Contractual Services,1296907,2879758,1167700,1706603,7050968
292,Finance,Office of Finance,A&F,Supplies & Materials,934,1476,2000,1250,5660
293,Finance,Office of Finance,A&F,Current Charges & Obligations,1472,3651,2508,2800,10431
294,Finance,Office of Finance,A&F,Equipment,23204,17593,0,0,40797
295,Finance,Assessing Department,Assessing Operations,Personnel Services,2290600,2466168,2592603,2326160,9675531
296,Finance,Assessing Department,Assessing Operations,Contractual Services,102546,109627,107100,111600,430873
297,Finance,Assessing Department,Assessing Operations,Supplies & Materials,50144,125527,56500,56740,288911
298,Finance,Assessing Department,Assessing Operations,Current Charges & Obligations,3648,2598,4500,5000,15746
299,Finance,Assessing Department,Valuation,Personnel Services,2961780,3241718,3588846,3707760,13500104
300,Finance,Assessing Department,Valuation,Contractual Services,177342,183401,180300,416200,957243
301,Finance,Assessing Department,Valuation,Supplies & Materials,6250,7250,9000,9000,31500
302,Finance,Assessing Department,Valuation,Current Charges & Obligations,47184,149590,156400,162300,515474
303,Finance,Assessing Department,Valuation,Equipment,15478,0,0,0,15478
304,Finance,Assessing Department,Executive,Personnel Services,972919,889102,1182925,1227090,4272036
305,Finance,Assessing Department,Executive,Contractual Services,35301,165437,194700,195000,590438
306,Finance,Assessing Department,Executive,Supplies & Materials,500,500,500,500,2000
307,Finance,Assessing Department,Executive,Current Charges & Obligations,6669,6275,5500,6000,24444
308,Finance,Auditing Department,Auditing Administration,Personnel Services,579292,521782,580415,634783,2316272
309,Finance,Auditing Department,Auditing Administration,Contractual Services,106174,106707,123402,123402,459685
310,Finance,Auditing Department,Auditing Administration,Supplies & Materials,2499,957,2707,2707,8870
311,Finance,Auditing Department,Auditing Administration,Current Charges & Obligations,1810,2663,1961,1961,8395
312,Finance,Auditing Department,Accounting,Personnel Services,656862,687081,771374,768452,2883769
313,Finance,Auditing Department,Accounting,Contractual Services,6835,258365,7885,7885,280970
314,Finance,Auditing Department,Accounting,Supplies & Materials,875,155,1757,1757,4544
315,Finance,Auditing Department,Accounting,Current Charges & Obligations,24343,19987,36973,36973,118276
316,Finance,Auditing Department,Central Payroll,Personnel Services,613102,504497,605222,642794,2365615
317,Finance,Auditing Department,Central Payroll,Contractual Services,2454,589,3795,3795,10633
318,Finance,Auditing Department,Central Payroll,Supplies & Materials,1000,1133,1400,1400,4933
319,Finance,Auditing Department,Central Payroll,Current Charges & Obligations,516,1507,516,516,3055
320,Finance,Auditing Department,Central Payroll,Equipment,0,2218,0,0,2218
321,Finance,Auditing Department,Grants Monitoring,Personnel Services,321741,352116,152194,202308,1028359
322,Finance,Auditing Department,Grants Monitoring,Contractual Services,2345,1758,3085,3085,10273
323,Finance,Auditing Department,Grants Monitoring,Supplies & Materials,658,15,957,957,2587
324,Finance,Auditing Department,Grants Monitoring,Current Charges & Obligations,365,1370,455,455,2645
325,Finance,Auditing Department,Accounts Payable,Personnel Services,663749,655808,757937,809351,2886845
326,Finance,Auditing Department,Accounts Payable,Contractual Services,8914,6497,7815,7815,31041
327,Finance,Auditing Department,Accounts Payable,Supplies & Materials,2729,1782,4707,4707,13925
328,Finance,Auditing Department,Accounts Payable,Current Charges & Obligations,0,3095,388,388,3871
329,Finance,Auditing Department,Accounts Payable,Equipment,0,2218,0,0,2218
330,Finance,Budget Management,Budget Administration,Personnel Services,865956,868922,1015814,1005238,3755930
331,Finance,Budget Management,Budget Administration,Contractual Services,431017,373366,162550,162550,1129483
332,Finance,Budget Management,Budget Administration,Supplies & Materials,3126,917,4850,4850,13743
333,Finance,Budget Management,Budget Administration,Current Charges & Obligations,54805,56183,63785,63785,238558
334,Finance,Budget Management,Budget Administration,Equipment,25170,6942,0,0,32112
335,Finance,Budget Management,Budget & Management,Personnel Services,805636,857130,958703,793438,3414907
336,Finance,Budget Management,Budget & Management,Contractual Services,1955,568,1800,1800,6123
337,Finance,Budget Management,Budget & Management,Supplies & Materials,0,0,500,500,1000
338,Finance,Budget Management,Revenue Monitoring,Personnel Services,84407,105797,110831,97571,398606
339,Finance,Budget Management,Revenue Monitoring,Contractual Services,0,0,560300,560300,1120600
340,Finance,Budget Management,Improving Management Project,Contractual Services,0,0,0,0,0
341,Finance,Budget Management,Improving Management Project,Contractual Services,0,0,0,0,0
342,Finance,Budget Management,Capital Budgeting,Personnel Services,369092,375068,393703,421102,1558965
343,Finance,Budget Management,Capital Budgeting,Contractual Services,700,254,600,600,2154
344,Finance,Budget Management,Capital Budgeting,Supplies & Materials,250,0,750,750,1750
345,Finance,Budget Management,Capital Budgeting,Current Charges & Obligations,0,0,0,0,0
346,Finance,Budget Management,Risk Management,Personnel Services,126676,130005,124850,103619,485150
347,Finance,Budget Management,Risk Management,Contractual Services,259,0,68270,68270,136799
348,Finance,Budget Management,Risk Management,Current Charges & Obligations,58250,58250,71485,70885,258870
349,Finance,Office of Participatory Budgeting,Participatory Budgeting Program,Personnel Services,0,0,0,240000,240000
350,Finance,Office of Participatory Budgeting,Participatory Budgeting Program,Contractual Services,0,0,0,5000,5000
351,Finance,Office of Participatory Budgeting,Participatory Budgeting Program,Equipment,0,0,0,5000,5000
352,Finance,Office of Participatory Budgeting,Participatory Budgeting Program,Other Expenses,0,0,1000000,1750000,2750000
353,Finance,Execution of Courts,Execution of Courts,Other Expenses,7083289,5790678,5000000,5000000,22873967
354,Finance,Pensions & Annuities - City,Pensions & Annuities - City,Tot Pension & Annuity,3515768,3429223,3900000,3900000,14744991
355,Finance,Procurement,Purchasing Administration,Personnel Services,860926,870392,836889,981897,3550104
356,Finance,Procurement,Purchasing Administration,Contractual Services,18249,16235,15753,16433,66670
357,Finance,Procurement,Purchasing Administration,Supplies & Materials,7424,2799,7500,7500,25223
358,Finance,Procurement,Purchasing Administration,Current Charges & Obligations,15518,11491,4515,4515,36039
359,Finance,Procurement,Purchasing Administration,Equipment,17507,12025,24332,24070,77934
360,Finance,Procurement,Purchasing Administration,Other Expenses,762219,91849,0,0,854068
361,Finance,Procurement,Procurement Operations,Personnel Services,537746,585651,701262,674345,2499004
362,Finance,Procurement,Procurement Operations,Contractual Services,1794,1609,202095,7021,212519
363,Finance,Procurement,Procurement Operations,Supplies & Materials,3905,1921,4975,4975,15776
364,Finance,Procurement,Procurement Operations,Current Charges & Obligations,126,290,400,400,1216
365,Finance,Procurement,Procurement Operations,Other Expenses,204389,46746,0,0,251135
366,Finance,Procurement,Central Services,Personnel Services,378350,325984,323121,326519,1353974
367,Finance,Procurement,Central Services,Contractual Services,54399,41526,26021,26021,147967
368,Finance,Procurement,Central Services,Supplies & Materials,3810,2647,2750,2750,11957
369,Finance,Procurement,Central Services,Current Charges & Obligations,0,25,150,150,325
370,Finance,Procurement,Central Services,Other Expenses,-93341,41807,6000,6000,-39534
371,Finance,Treasury-Collecting,General Management,Personnel Services,481265,505212,487440,623579,2097496
372,Finance,Treasury-Collecting,General Management,Contractual Services,37360,80450,496250,496250,1110310
373,Finance,Treasury-Collecting,General Management,Supplies & Materials,9265,5096,18500,18500,51361
374,Finance,Treasury-Collecting,General Management,Current Charges & Obligations,13989,2454,16500,17000,49943
375,Finance,Treasury-Collecting,Special Collections,Personnel Services,582735,578415,623413,512493,2297056
376,Finance,Treasury-Collecting,Special Collections,Contractual Services,2068,1623,3962,3962,11615
377,Finance,Treasury-Collecting,Special Collections,Supplies & Materials,2250,2500,2250,2250,9250
378,Finance,Treasury-Collecting,Payment Services,Personnel Services,302800,312386,326872,454848,1396906
379,Finance,Treasury-Collecting,Payment Services,Contractual Services,355682,409509,1525,1525,768241
380,Finance,Treasury-Collecting,Payment Services,Supplies & Materials,548274,499549,516500,516500,2080823
381,Finance,Treasury-Collecting,Payment Services,Equipment,248,5816,20000,20000,46064
382,Finance,Treasury-Collecting,Payment Services,Other Expenses,361004,579792,0,0,940796
383,Finance,Treasury-Collecting,Accounting/Quality Control,Personnel Services,372721,396024,423318,351219,1543282
384,Finance,Treasury-Collecting,Accounting/Quality Control,Contractual Services,1380,1018,1213,1213,4824
385,Finance,Treasury-Collecting,Accounting/Quality Control,Supplies & Materials,500,500,500,500,2000
386,Finance,Treasury Division,Treasury Administration,Personnel Services,507926,510542,459661,519332,1997461
387,Finance,Treasury Division,Treasury Administration,Contractual Services,197343,136717,144500,203108,681668
388,Finance,Treasury Division,Treasury Administration,Supplies & Materials,14992,14791,15000,15000,59783
389,Finance,Treasury Division,Treasury Administration,Current Charges & Obligations,14449,12204,19000,19000,64653
390,Finance,Treasury Division,General Service/Payroll,Personnel Services,421851,377615,431115,359939,1590520
391,Finance,Treasury Division,General Service/Payroll,Contractual Services,15902,16731,25400,25400,83433
392,Finance,Treasury Division,General Service/Payroll,Supplies & Materials,240395,240052,245250,245500,971197
393,Finance,Treasury Division,Treasury Accounting,Personnel Services,175415,180807,188304,168668,713194
394,Finance,Treasury Division,Treasury Accounting,Contractual Services,620,267,900,900,2687
395,Finance,Treasury Division,Treasury Accounting,Supplies & Materials,4500,4500,4750,4750,18500
396,Finance,Treasury Division,Accounts Receivable,Personnel Services,404767,417902,431207,510172,1764048
397,Finance,Treasury Division,Accounts Receivable,Contractual Services,841,207,900,900,2848
398,Finance,Treasury Division,Accounts Receivable,Supplies & Materials,16685,17000,17000,17000,67685
399,Finance,Treasury Division,Trust,Personnel Services,83,632,0,0,715
400,Finance,Treasury Division,Trust,Contractual Services,0,0,0,0,0
401,Finance,Treasury Division,Trust,Other Expenses,15000000,0,0,0,15000000
402,People Operations,Office of People Operations,People Administration,Personnel Services,0,0,0,389108,389108
403,People Operations,Office of People Operations,People Administration,Contractual Services,0,0,0,103000,103000
404,People Operations,Office of People Operations,People Administration,Supplies & Materials,0,0,0,1000,1000
405,People Operations,Office of People Operations,People Administration,Current Charges & Obligations,0,0,0,1000,1000
406,People Operations,Office of People Operations,People Administration,Equipment,0,0,0,2000,2000
407,People Operations,Health Insurance,Health Insur,Current Charges & Obligations,211341951,210900841,212236570,217310394,851789756
408,People Operations,Human Resources,Personnel,Personnel Services,1903365,2015785,2790704,2753851,9463705
409,People Operations,Human Resources,Personnel,Contractual Services,93804,94646,396418,1245818,1830686
410,People Operations,Human Resources,Personnel,Supplies & Materials,7421,5561,5580,5580,24142
411,People Operations,Human Resources,Personnel,Current Charges & Obligations,752373,781483,925124,925637,3384617
412,People Operations,Human Resources,Personnel,Equipment,75801,22461,0,0,98262
413,People Operations,Human Resources,Affirmative Action,Contractual Services,205089,2024410,61625,61625,2352749
414,People Operations,Human Resources,Affirmative Action,Current Charges & Obligations,1100,550,2000,2000,5650
415,People Operations,Human Resources,Health Benefits & Insurance,Personnel Services,856081,847645,866981,975852,3546559
416,People Operations,Human Resources,Health Benefits & Insurance,Contractual Services,11515,14438,18600,48494,93047
417,People Operations,Human Resources,Health Benefits & Insurance,Supplies & Materials,29063,43741,43400,43400,159604
418,People Operations,Human Resources,Health Benefits & Insurance,Current Charges & Obligations,4310,1114,455,1250,7129
419,People Operations,Human Resources,Health Benefits & Insurance,Equipment,14332,475,0,0,14807
420,People Operations,Human Resources,Employee Assistance,Personnel Services,231557,257563,306434,629593,1425147
421,People Operations,Human Resources,Employee Assistance,Contractual Services,557,254,600,600,2011
422,People Operations,Human Resources,Employee Assistance,Supplies & Materials,0,0,500,500,1000
423,People Operations,Human Resources,Employee Assistance,Current Charges & Obligations,0,0,252,252,504
424,People Operations,Human Resources,Employee Assistance,Equipment,0,1955,0,0,1955
425,People Operations,Human Resources,Workers' Comp,Personnel Services,749827,713424,651121,789138,2903510
426,People Operations,Human Resources,Workers' Comp,Contractual Services,14078,3381,6550,5550,29559
427,People Operations,Human Resources,Workers' Comp,Supplies & Materials,6171,2392,8450,8450,25463
428,People Operations,Human Resources,Workers' Comp,Current Charges & Obligations,149344,24027,132634,135094,441099
429,People Operations,Human Resources,Workers' Comp,Equipment,3472,0,0,0,3472
430,People Operations,Medicare,Medicare,Total Medicare,10618969,10542664,12635794,12635794,46433221
431,People Operations,Office of Labor Relations,Labor Relations,Personnel Services,804291,831980,1009358,1363403,4009032
432,People Operations,Office of Labor Relations,Labor Relations,Contractual Services,474786,425171,556840,556814,2013611
433,People Operations,Office of Labor Relations,Labor Relations,Supplies & Materials,1267,434,2800,2700,7201
434,People Operations,Office of Labor Relations,Labor Relations,Current Charges & Obligations,28832,38411,36224,38250,141717
435,People Operations,Office of Labor Relations,Labor Relations,Equipment,0,1605,0,0,1605
436,People Operations,Registry Division,Administration,Personnel Services,331367,331409,360270,391014,1414060
437,People Operations,Registry Division,Administration,Contractual Services,11421,9315,8940,13053,42729
438,People Operations,Registry Division,Administration,Supplies & Materials,12906,13520,22650,30576,79652
439,People Operations,Registry Division,Administration,Current Charges & Obligations,150,377,150,150,827
440,People Operations,Registry Division,Vital Statistics,Personnel Services,530096,545849,563231,545728,2184904
441,People Operations,Registry Division,Vital Statistics,Contractual Services,27636,13237,33320,30960,105153
442,People Operations,Registry Division,Vital Statistics,Supplies & Materials,24151,23946,14750,14750,77597
443,People Operations,Registry Division,Vital Statistics,Current Charges & Obligations,227,0,280,280,787
444,People Operations,Registry Division,Vital Statistics,Equipment,20635,3270,0,0,23905
445,People Operations,Registry Division,Depositions,Personnel Services,118685,142609,148109,153821,563224
446,People Operations,Registry Division,Depositions,Contractual Services,0,-7,0,0,-7
447,People Operations,Registry Division,Depositions,Supplies & Materials,250,250,250,250,1000
448,People Operations,Registry Division,Depositions,Current Charges & Obligations,598,598,600,600,2396
449,People Operations,Unemployment Compensation,Unemployment Compensation,Tot Unemployment Compensation,634863,528212,350000,350000,1863075
450,People Operations,Workers' Compensation Fund,Workers' Compensation Fund,Personnel Services,4632,1831834,0,0,1836466
451,People Operations,Workers' Compensation Fund,Workers' Compensation Fund,Supplies & Materials,0,275,0,0,275
452,People Operations,Workers' Compensation Fund,Workers' Compensation Fund,Other Expenses,1762683,7665,2000000,2000000,5770348
453,Human Services,Office of Human Services,Human Services Office,Personnel Services,0,699808,624665,869146,2193619
454,Human Services,Office of Human Services,Human Services Office,Contractual Services,0,1059931,3585000,2231980,6876911
455,Human Services,Office of Human Services,Human Services Office,Supplies & Materials,0,839,7000,7750,15589
456,Human Services,Office of Human Services,Mayor's Office of Food Access,Personnel Services,0,275896,339735,0,615631
457,Human Services,Office of Human Services,Mayor's Office of Food Access,Contractual Services,0,395319,763000,0,1158319
458,Human Services,Office of Human Services,Mayor's Office of Food Access,Supplies & Materials,0,2925,2000,0,4925
459,Human Services,Office of Human Services,Mayor's Office of Food Access,Current Charges & Obligations,0,0,150,0,150
460,Human Services,Office of Human Services,Mayor's Office of Food Access,Equipment,0,765,0,0,765
461,Human Services,Office of Human Services,Mayor's Office of Public Safety,Personnel Services,0,0,440816,713326,1154142
462,Human Services,Office of Human Services,Mayor's Office of Public Safety,Contractual Services,0,0,128918,1960918,2089836
463,Human Services,Office of Human Services,Mayor's Office of Public Safety,Supplies & Materials,0,0,3000,3000,6000
464,Human Services,Boston Center for Youth & Families,Administration & Policy,Personnel Services,13596951,12492577,12363590,12086645,50539763
465,Human Services,Boston Center for Youth & Families,Administration & Policy,Contractual Services,3196584,3167630,2999628,3119077,12482919
466,Human Services,Boston Center for Youth & Families,Administration & Policy,Supplies & Materials,433623,263323,394148,358698,1449792
467,Human Services,Boston Center for Youth & Families,Administration & Policy,Current Charges & Obligations,122093,128045,282312,282892,815342
468,Human Services,Boston Center for Youth & Families,Administration & Policy,Equipment,163645,98366,268126,317617,847754
469,Human Services,Boston Center for Youth & Families,Sports & Fitness,Personnel Services,4167296,4416704,4950962,5107019,18641981
470,Human Services,Boston Center for Youth & Families,Sports & Fitness,Contractual Services,564,357,500000,500500,1001421
471,Human Services,Boston Center for Youth & Families,Youth & Family Services,Personnel Services,3996411,4233249,4843192,4905261,17978113
472,Human Services,Boston Center for Youth & Families,Youth & Family Services,Contractual Services,215784,41814,301000,301000,859598
473,Human Services,Boston Center for Youth & Families,Youth & Family Services,Supplies & Materials,14217,0,0,7500,21717
474,Human Services,Boston Center for Youth & Families,Youth & Family Services,Current Charges & Obligations,40924,48102,50000,50000,189026
475,Human Services,Boston Center for Youth & Families,Youth & Family Services,Equipment,50265,7275,20418,28686,106644
476,Human Services,Boston Center for Youth & Families,Child Care & Out-of-School,Personnel Services,1271585,1154871,1545164,1538398,5510018
477,Human Services,Boston Center for Youth & Families,Child Care & Out-of-School,Contractual Services,1268295,851471,1179500,1179500,4478766
478,Human Services,Boston Center for Youth & Families,Child Care & Out-of-School,Supplies & Materials,7229,1075,12600,9600,30504
479,Human Services,Boston Center for Youth & Families,Child Care & Out-of-School,Current Charges & Obligations,0,0,2500,2500,5000
480,Human Services,Age Strong,Age Strong Administration,Personnel Services,968389,762883,1070654,1112047,3913973
481,Human Services,Age Strong,Age Strong Administration,Contractual Services,167906,311470,56660,257175,793211
482,Human Services,Age Strong,Age Strong Administration,Supplies & Materials,12991,8710,13950,8850,44501
483,Human Services,Age Strong,Age Strong Administration,Current Charges & Obligations,33094,50786,9680,25610,119170
484,Human Services,Age Strong,Age Strong Operations,Personnel Services,518568,499873,755168,741112,2514721
485,Human Services,Age Strong,Age Strong Operations,Contractual Services,398915,302538,958270,510350,2170073
486,Human Services,Age Strong,Age Strong Operations,Supplies & Materials,113670,5455,230630,229445,579200
487,Human Services,Age Strong,Age Strong Operations,Current Charges & Obligations,2700,250,47700,50000,100650
488,Human Services,Age Strong,Age Strong Transportation,Personnel Services,1291342,1264268,1408942,1418827,5383379
489,Human Services,Age Strong,Age Strong Transportation,Contractual Services,67755,66757,78800,69000,282312
490,Human Services,Age Strong,Age Strong Transportation,Supplies & Materials,54094,50541,60140,77941,242716
491,Human Services,Age Strong,Age Strong Transportation,Current Charges & Obligations,15512,7215,0,12500,35227
492,Human Services,Age Strong,Age Strong Transportation,Equipment,0,150248,0,34832,185080
493,Human Services,Age Strong,Program & Partnerships,Personnel Services,229408,267282,268598,485097,1250385
494,Human Services,Age Strong,Program & Partnerships,Contractual Services,416,135177,300000,968000,1403593
495,Human Services,Age Strong,Program & Partnerships,Supplies & Materials,250,500,1330,1330,3410
496,Human Services,Library Department,Library Administration,Personnel Services,8674831,9186158,9178378,9519331,36558698
497,Human Services,Library Department,Library Administration,Contractual Services,7847652,8464777,9014574,9188482,34515485
498,Human Services,Library Department,Library Administration,Supplies & Materials,4059432,4191014,3325008,3914686,15490140
499,Human Services,Library Department,Library Administration,Current Charges & Obligations,358340,286819,590404,614872,1850435
500,Human Services,Library Department,Library Administration,Equipment,339626,354528,435076,390254,1519484
501,Human Services,Library Department,Library Administration,Other Expenses,26122,35000,35000,35000,131122
502,Human Services,Library Department,Community Library Services,Personnel Services,15860857,15612791,17451514,17793336,66718498
503,Human Services,Library Department,Community Library Services,Contractual Services,135342,18421,380000,100000,633763
504,Human Services,Library Department,Community Library Services,Current Charges & Obligations,18613,15573,21000,21000,76186
505,Human Services,Library Department,Research Services,Personnel Services,1794676,1674383,1811903,1697285,6978247
506,Human Services,Library Department,Research Services,Contractual Services,4137,1860,0,0,5997
507,Human Services,Boston VETS,Veterans' Services,Personnel Services,931839,911831,1022491,1108416,3974577
508,Human Services,Boston VETS,Veterans' Services,Contractual Services,98821,87376,195202,185202,566601
509,Human Services,Boston VETS,Veterans' Services,Supplies & Materials,59269,44362,71550,71550,246731
510,Human Services,Boston VETS,Veterans' Services,Current Charges & Obligations,1810387,1564411,3331601,3331601,10038000
511,Human Services,Boston VETS,Veterans' Services,Equipment,440,0,0,0,440
512,Human Services,Youth Engagement & Employment,Youth Engagement & Employment Program,Personnel Services,6439695,6254011,10901145,10623481,34218332
513,Human Services,Youth Engagement & Employment,Youth Engagement & Employment Program,Contractual Services,61837,286539,140811,6399453,6888640
514,Human Services,Youth Engagement & Employment,Youth Engagement & Employment Program,Supplies & Materials,41915,35445,68500,68500,214360
515,Human Services,Youth Engagement & Employment,Youth Engagement & Employment Program,Current Charges & Obligations,58725,8905,797996,56496,922122
516,Human Services,Youth Engagement & Employment,Youth Engagement & Employment Program,Equipment,33361,12222,4500,4500,54583
517,Human Services,Youth Engagement & Employment,Youth Engagement & Employment Program,Other Expenses,562500,562500,562500,562500,2250000
518,Public Health,Public Health Commission,Public Health Commission,Personnel Services,0,0,0,0,0
519,Public Health,Public Health Commission,Public Health Commission,Contractual Services,0,0,0,0,0
520,Public Health,Public Health Commission,Public Health Commission,Other Expenses,93405427,106473529,110850881,117884077,428613914
521,Housing,Mayor's Office of Housing,Mayor's Office of Housing Administration,Personnel Services,1382499,1550222,1499892,1710036,6142649
522,Housing,Mayor's Office of Housing,Mayor's Office of Housing Administration,Contractual Services,221789,396215,201507,760360,1579871
523,Housing,Mayor's Office of Housing,Mayor's Office of Housing Administration,Supplies & Materials,21957,14842,27999,22000,86798
524,Housing,Mayor's Office of Housing,Mayor's Office of Housing Administration,Current Charges & Obligations,57800,67245,99426,92938,317409
525,Housing,Mayor's Office of Housing,Mayor's Office of Housing Administration,Equipment,6735,6470,22986,22986,59177
526,Housing,Mayor's Office of Housing,Real Estate Management & Sales,Personnel Services,1076885,881977,869606,978132,3806600
527,Housing,Mayor's Office of Housing,Real Estate Management & Sales,Contractual Services,951644,1075305,2293700,2093700,6414349
528,Housing,Mayor's Office of Housing,Real Estate Management & Sales,Supplies & Materials,1918,1750,6750,6750,17168
529,Housing,Mayor's Office of Housing,Real Estate Management & Sales,Current Charges & Obligations,10325,13770,31650,31650,87395
530,Housing,Mayor's Office of Housing,Housing Development & Services,Personnel Services,1355720,1717317,1863553,2859648,7796238
531,Housing,Mayor's Office of Housing,Housing Development & Services,Contractual Services,483990,462141,2988500,488500,4423131
532,Housing,Mayor's Office of Housing,Housing Development & Services,Supplies & Materials,2625,3370,3750,3750,13495
533,Housing,Mayor's Office of Housing,Housing Development & Services,Current Charges & Obligations,24,0,0,0,24
534,Housing,Mayor's Office of Housing,Housing Development & Services,Other Expenses,14890452,22863343,25463343,35213343,98430481
535,Information & Technology,Department of Innovation and Technology,DoIT Operations,Personnel Services,1704482,1630258,1935665,1828289,7098694
536,Information & Technology,Department of Innovation and Technology,DoIT Operations,Contractual Services,2439812,4680716,925052,640971,8686551
537,Information & Technology,Department of Innovation and Technology,DoIT Operations,Supplies & Materials,14423,222944,12200,12450,262017
538,Information & Technology,Department of Innovation and Technology,DoIT Operations,Current Charges & Obligations,511513,1301986,2065462,188688,4067649
539,Information & Technology,Department of Innovation and Technology,DoIT Operations,Equipment,222304,938113,834117,765643,2760177
540,Information & Technology,Department of Innovation and Technology,Enterprise Applications,Personnel Services,5565643,5582106,5692300,5644577,22484626
541,Information & Technology,Department of Innovation and Technology,Enterprise Applications,Contractual Services,4229818,2020284,925600,100000,7275702
542,Information & Technology,Department of Innovation and Technology,Enterprise Applications,Current Charges & Obligations,8811853,6428644,6544874,8729944,30515315
543,Information & Technology,Department of Innovation and Technology,Digital Engagement & Services,Personnel Services,870295,783328,855702,1041450,3550775
544,Information & Technology,Department of Innovation and Technology,Digital Engagement & Services,Contractual Services,352957,145,180257,362000,895359
545,Information & Technology,Department of Innovation and Technology,Digital Engagement & Services,Current Charges & Obligations,256849,844821,724556,854680,2680906
546,Information & Technology,Department of Innovation and Technology,Digital Engagement & Services,Equipment,0,0,5000,5000,10000
547,Information & Technology,Department of Innovation and Technology,Core Infrastructure,Personnel Services,4408506,4528658,4148983,4415540,17501687
548,Information & Technology,Department of Innovation and Technology,Core Infrastructure,Contractual Services,3790502,2675862,3237438,4250394,13954196
549,Information & Technology,Department of Innovation and Technology,Core Infrastructure,Supplies & Materials,36624,22893,29250,30250,119017
550,Information & Technology,Department of Innovation and Technology,Core Infrastructure,Current Charges & Obligations,6233900,7947246,8215933,10431137,32828216
551,Information & Technology,Department of Innovation and Technology,Core Infrastructure,Equipment,985239,78389,81797,242762,1388187
552,Information & Technology,Department of Innovation and Technology,Data & Analytics,Personnel Services,662572,594283,919588,1058891,3235334
553,Information & Technology,Department of Innovation and Technology,Data & Analytics,Contractual Services,1011262,55012,34775,100000,1201049
554,Information & Technology,Department of Innovation and Technology,Data & Analytics,Current Charges & Obligations,512116,504047,1096147,513113,2625423
555,Information & Technology,Department of Innovation and Technology,Broadband & Digital Equity,Personnel Services,446119,383818,480404,537119,1847460
556,Information & Technology,Department of Innovation and Technology,Broadband & Digital Equity,Contractual Services,279,-70,1300000,191500,1491709
557,Information & Technology,Department of Innovation and Technology,Broadband & Digital Equity,Supplies & Materials,250,250,250,250,1000
558,Public Safety,Emergency Management,Homeland Security,Personnel Services,271167,330906,441882,551201,1595156
559,Public Safety,Emergency Management,Homeland Security,Contractual Services,173816,294800,310508,343508,1122632
560,Public Safety,Emergency Management,Homeland Security,Supplies & Materials,4944,2796,6000,6000,19740
561,Public Safety,Emergency Management,Homeland Security,Current Charges & Obligations,353600,366090,375600,386857,1482147
562,Public Safety,Emergency Management,Homeland Security,Equipment,2631,11914,0,0,14545
563,Public Safety,Fire Department,BFD Administration,Personnel Services,13043652,12592230,14575634,16664714,56876230
564,Public Safety,Fire Department,BFD Administration,Contractual Services,2683371,2776881,2880554,3019667,11360473
565,Public Safety,Fire Department,BFD Administration,Supplies & Materials,124765,88805,212034,211825,637429
566,Public Safety,Fire Department,BFD Administration,Current Charges & Obligations,4818336,3753365,3941716,3942579,16455996
567,Public Safety,Fire Department,BFD Administration,Equipment,0,0,0,0,0
568,Public Safety,Fire Department,Boston Fire Suppression,Personnel Services,201001394,199783710,203184251,202171628,806140983
569,Public Safety,Fire Department,Boston Fire Suppression,Contractual Services,1050013,1135817,1170560,1170560,4526950
570,Public Safety,Fire Department,Boston Fire Suppression,Supplies & Materials,2967230,2475576,2710331,3132139,11285276
571,Public Safety,Fire Department,Boston Fire Suppression,Current Charges & Obligations,40848,6170,51132,51132,149282
572,Public Safety,Fire Department,Boston Fire Suppression,Equipment,3534896,3830745,2271454,2022385,11659480
573,Public Safety,Fire Department,Fire Alarm,Personnel Services,8415281,7907474,9574336,9434858,35331949
574,Public Safety,Fire Department,Fire Alarm,Contractual Services,1222933,1289517,1345180,1360120,5217750
575,Public Safety,Fire Department,Fire Alarm,Supplies & Materials,187807,100191,168179,147679,603856
576,Public Safety,Fire Department,Fire Alarm,Current Charges & Obligations,174688,306248,257998,257998,996932
577,Public Safety,Fire Department,Fire Alarm,Equipment,429944,582064,1067039,914870,2993917
578,Public Safety,Fire Department,BFD Training,Personnel Services,4532788,4302070,4682694,5585079,19102631
579,Public Safety,Fire Department,BFD Training,Contractual Services,343838,88743,120850,100800,654231
580,Public Safety,Fire Department,BFD Training,Supplies & Materials,90199,74462,129965,129965,424591
581,Public Safety,Fire Department,BFD Training,Current Charges & Obligations,2991,2230,16130,16130,37481
582,Public Safety,Fire Department,BFD Training,Equipment,34871,23517,84100,41100,183588
583,Public Safety,Fire Department,BFD Maintenance,Personnel Services,3559223,3544003,3828162,3955169,14886557
584,Public Safety,Fire Department,BFD Maintenance,Contractual Services,4018591,4104454,4108737,3708737,15940519
585,Public Safety,Fire Department,BFD Maintenance,Supplies & Materials,2404098,2784897,2465875,2465875,10120745
586,Public Safety,Fire Department,BFD Maintenance,Current Charges & Obligations,46947,53467,58753,718753,877920
587,Public Safety,Fire Department,BFD Maintenance,Equipment,7841737,2751600,1399260,616939,12609536
588,Public Safety,Fire Department,BFD Maintenance,Other Expenses,17449,29997,20000,20000,87446
589,Public Safety,Fire Department,BFD Fire Prevention,Personnel Services,13317105,13496707,14217416,13818274,54849502
590,Public Safety,Fire Department,BFD Fire Prevention,Contractual Services,50856,53341,126981,126981,358159
591,Public Safety,Fire Department,BFD Fire Prevention,Supplies & Materials,102578,79183,141450,141450,464661
592,Public Safety,Fire Department,BFD Fire Prevention,Current Charges & Obligations,120444,145319,164887,132819,563469
593,Public Safety,Fire Department,BFD Fire Prevention,Equipment,533,15720,1800,1800,19853
594,Public Safety,Fire Department,"Firefighter Safety, Health and Wellness",Personnel Services,676914,710661,715448,720364,2823387
595,Public Safety,Fire Department,"Firefighter Safety, Health and Wellness",Contractual Services,131732,61236,77000,77000,346968
596,Public Safety,Fire Department,"Firefighter Safety, Health and Wellness",Supplies & Materials,21178,2336,22200,22200,67914
597,Public Safety,Fire Department,"Firefighter Safety, Health and Wellness",Current Charges & Obligations,0,0,1000,1000,2000
598,Public Safety,Fire Department,"Firefighter Safety, Health and Wellness",Equipment,3798,7190,15000,0,25988
599,Public Safety,Police Department,Police Commissioner's Office,Personnel Services,9129493,15107448,13188722,12533766,49959429
600,Public Safety,Police Department,Police Commissioner's Office,Contractual Services,602687,625980,688984,714584,2632235
601,Public Safety,Police Department,Police Commissioner's Office,Supplies & Materials,86321,111188,51400,50900,299809
602,Public Safety,Police Department,Police Commissioner's Office,Current Charges & Obligations,35188,32052,31255,35123,133618
603,Public Safety,Police Department,Police Commissioner's Office,Equipment,4902,6282,25885,25885,62954
604,Public Safety,Police Department,Bureau of Community Engagement,Personnel Services,4224644,4061873,4117094,4122892,16526503
605,Public Safety,Police Department,Bureau of Community Engagement,Contractual Services,0,640,80525,110000,191165
606,Public Safety,Police Department,Bureau of Community Engagement,Supplies & Materials,23385,22675,15000,20000,81060
607,Public Safety,Police Department,Bureau of Community Engagement,Current Charges & Obligations,120,120,2000,7500,9740
608,Public Safety,Police Department,Bureau of Community Engagement,Equipment,0,0,6500,12500,19000
609,Public Safety,Police Department,BAT-Operations,Personnel Services,290489,6457190,7023854,6914533,20686066
610,Public Safety,Police Department,BAT-Operations,Contractual Services,4168120,3758262,3518255,3914902,15359539
611,Public Safety,Police Department,BAT-Operations,Supplies & Materials,3734831,3220538,3795006,4426341,15176716
612,Public Safety,Police Department,BAT-Operations,Current Charges & Obligations,316420,296962,571660,580160,1765202
613,Public Safety,Police Department,BAT-Operations,Equipment,4314193,7926530,4368169,4221829,20830721
614,Public Safety,Police Department,BAT-Admin & Technology,Personnel Services,55191808,58557011,59641767,56289125,229679711
615,Public Safety,Police Department,BAT-Admin & Technology,Contractual Services,14804270,15371484,15612403,18828995,64617152
616,Public Safety,Police Department,BAT-Admin & Technology,Supplies & Materials,1371803,1001241,703085,819683,3895812
617,Public Safety,Police Department,BAT-Admin & Technology,Current Charges & Obligations,4813727,7111876,4500855,4654836,21081294
618,Public Safety,Police Department,BAT-Admin & Technology,Equipment,1117148,2222092,1078209,1487400,5904849
619,Public Safety,Police Department,Bureau of Professional Development,Personnel Services,19419080,6065867,5340111,5390288,36215346
620,Public Safety,Police Department,Bureau of Professional Development,Contractual Services,174599,89084,200956,236546,701185
621,Public Safety,Police Department,Bureau of Professional Development,Supplies & Materials,617273,323967,263164,582626,1787030
622,Public Safety,Police Department,Bureau of Professional Development,Current Charges & Obligations,41818,29728,9950,9950,91446
623,Public Safety,Police Department,Bureau of Professional Development,Equipment,40958,12742,29100,29100,111900
624,Public Safety,Police Department,Bureau of Field Services,Personnel Services,199827050,195968566,189784872,187010013,772590501
625,Public Safety,Police Department,Bureau of Field Services,Contractual Services,469971,497872,286471,290481,1544795
626,Public Safety,Police Department,Bureau of Field Services,Supplies & Materials,1753093,1540739,2360640,2399975,8054447
627,Public Safety,Police Department,Bureau of Field Services,Current Charges & Obligations,2463,2292,2200,52600,59555
628,Public Safety,Police Department,Bureau of Field Services,Equipment,112309,201991,171175,239072,724547
629,Public Safety,Police Department,Bureau of Professional Standards,Personnel Services,6178037,5425993,4606907,4258615,20469552
630,Public Safety,Police Department,Bureau of Professional Standards,Contractual Services,62656,85529,63843,130118,342146
631,Public Safety,Police Department,Bureau of Professional Standards,Supplies & Materials,24933,20867,0,0,45800
632,Public Safety,Police Department,Bureau of Professional Standards,Current Charges & Obligations,60082,50722,40730,40730,192264
633,Public Safety,Police Department,Bureau of Professional Standards,Equipment,186,380,5000,5000,10566
634,Public Safety,Police Department,Bureau of Investigative Services,Personnel Services,85351784,80589543,72608629,69713701,308263657
635,Public Safety,Police Department,Bureau of Investigative Services,Contractual Services,374691,450260,503809,628241,1957001
636,Public Safety,Police Department,Bureau of Investigative Services,Supplies & Materials,804242,618142,472826,493304,2388514
637,Public Safety,Police Department,Bureau of Investigative Services,Current Charges & Obligations,180649,346336,122485,148969,798439
638,Public Safety,Police Department,Bureau of Investigative Services,Equipment,521306,144870,188633,83090,937899
639,Public Safety,Police Department,Special Operations,Total Overtime,0,0,589090,0,589090
640,Public Safety,Police Department,Bureau of Intelligence & Analysis,Personnel Services,5284611,4542834,3634970,3581423,17043838
641,Public Safety,Police Department,Bureau of Intelligence & Analysis,Contractual Services,557,-18,0,0,539
642,Public Safety,Police Department,Bureau of Intelligence & Analysis,Supplies & Materials,21317,17750,0,0,39067
643,Streets,Central Fleet Management,Fleet Services,Personnel Services,2295163,2463204,2364889,2395145,9518401
644,Streets,Central Fleet Management,Fleet Services,Contractual Services,376472,158137,502796,452796,1490201
645,Streets,Central Fleet Management,Fleet Services,Supplies & Materials,501650,475685,110465,104585,1192385
646,Streets,Central Fleet Management,Fleet Services,Current Charges & Obligations,8583,105353,6350,6350,126636
647,Streets,Central Fleet Management,Fleet Services,Equipment,328128,244165,295715,364203,1232211
648,Streets,Office of Streets,Admin & Finance,Personnel Services,1988514,1920900,2297448,2563619,8770481
649,Streets,Office of Streets,Admin & Finance,Contractual Services,37235,396,24050,24050,85731
650,Streets,Office of Streets,Admin & Finance,Supplies & Materials,1750,1500,6400,6650,16300
651,Streets,Office of Streets,Admin & Finance,Current Charges & Obligations,9950,1576,6610,6600,24736
652,Streets,Office of Streets,Admin & Finance,Equipment,2853,2385,1044,172,6454
653,Streets,Public Works Department,PWD Commissioner's Office,Personnel Services,1237729,1178034,1285605,1282786,4984154
654,Streets,Public Works Department,PWD Commissioner's Office,Contractual Services,322432,314623,294500,298500,1230055
655,Streets,Public Works Department,PWD Commissioner's Office,Supplies & Materials,153746,42307,115600,119558,431211
656,Streets,Public Works Department,PWD Commissioner's Office,Current Charges & Obligations,389211,543363,567000,532500,2032074
657,Streets,Public Works Department,PWD Commissioner's Office,Equipment,7255,5729,2101,0,15085
658,Streets,Public Works Department,Building/Facility Maintenance,Personnel Services,738771,778922,797751,849731,3165175
659,Streets,Public Works Department,Building/Facility Maintenance,Contractual Services,1856004,1521429,1825147,2088614,7291194
660,Streets,Public Works Department,Building/Facility Maintenance,Supplies & Materials,78328,67358,68913,72612,287211
661,Streets,Public Works Department,Building/Facility Maintenance,Current Charges & Obligations,2493,2598,3670,3670,12431
662,Streets,Public Works Department,Building/Facility Maintenance,Equipment,39591,52060,116651,139738,348040
663,Streets,Public Works Department,Engineering,Personnel Services,1563990,1571890,1952240,2142934,7231054
664,Streets,Public Works Department,Engineering,Contractual Services,79662,78362,87695,94795,340514
665,Streets,Public Works Department,Engineering,Supplies & Materials,15372,16161,23337,23661,78531
666,Streets,Public Works Department,Engineering,Current Charges & Obligations,21123,28473,13120,29550,92266
667,Streets,Public Works Department,Engineering,Equipment,32432,32245,49668,49989,164334
668,Streets,Public Works Department,Construction Management,Personnel Services,2288720,2084686,3127891,3100902,10602199
669,Streets,Public Works Department,Construction Management,Contractual Services,247300,193588,156250,203250,800388
670,Streets,Public Works Department,Construction Management,Supplies & Materials,22528,34781,42017,43958,143284
671,Streets,Public Works Department,Construction Management,Current Charges & Obligations,4908,7054,7080,9800,28842
672,Streets,Public Works Department,Construction Management,Equipment,68986,68986,77882,43234,259088
673,Streets,Public Works Department,Highway Field Operations,Personnel Services,9275865,9353442,10646014,10923055,40198376
674,Streets,Public Works Department,Highway Field Operations,Contractual Services,6829160,6103254,7161151,7046599,27140164
675,Streets,Public Works Department,Highway Field Operations,Supplies & Materials,975884,830780,1028320,1254842,4089826
676,Streets,Public Works Department,Highway Field Operations,Current Charges & Obligations,36200,12757,5500,35000,89457
677,Streets,Public Works Department,Highway Field Operations,Equipment,1968096,1463637,1793272,1933456,7158461
678,Streets,Public Works Department,Bridge Operations/Maintenance,Personnel Services,1081981,1099802,1127816,1117324,4426923
679,Streets,Public Works Department,Bridge Operations/Maintenance,Contractual Services,871188,832115,691663,831900,3226866
680,Streets,Public Works Department,Bridge Operations/Maintenance,Supplies & Materials,3977,4103,26685,26849,61614
681,Streets,Public Works Department,Bridge Operations/Maintenance,Current Charges & Obligations,515,466,780,800,2561
682,Streets,Public Works Department,Bridge Operations/Maintenance,Equipment,12722,6361,0,0,19083
683,Streets,Public Works Department,Street Lights,Personnel Services,2764296,2806076,3387466,3361145,12318983
684,Streets,Public Works Department,Street Lights,Contractual Services,5794237,5536211,6204212,6679422,24214082
685,Streets,Public Works Department,Street Lights,Supplies & Materials,76286,114079,90009,110936,391310
686,Streets,Public Works Department,Street Lights,Current Charges & Obligations,1834,5404,20500,13000,40738
687,Streets,Public Works Department,Street Lights,Equipment,345203,205061,310173,547533,1407970
688,Streets,Public Works Department,Street Lights,Other Expenses,281517,388607,600000,600000,1870124
689,Streets,Public Works Department,Waste Reduction,Personnel Services,2411699,2400601,2552909,2987814,10353023
690,Streets,Public Works Department,Waste Reduction,Contractual Services,52767912,53818890,55474913,56653684,218715399
691,Streets,Public Works Department,Waste Reduction,Supplies & Materials,489981,520842,558526,506123,2075472
692,Streets,Public Works Department,Waste Reduction,Current Charges & Obligations,6615,14937,3000,4330,28882
693,Streets,Public Works Department,Waste Reduction,Equipment,18135,12559,120937,191955,343586
694,Streets,Snow & Winter Management,Snow & Winter Mgmt,Contractual Services,22277848,18487266,21336401,22640141,84741656
695,Streets,Snow & Winter Management,Snow & Winter Mgmt,Supplies & Materials,43783,44579,57500,57500,203362
696,Streets,Snow & Winter Management,Snow & Winter Mgmt,Current Charges & Obligations,204,0,0,0,204
697,Streets,Snow & Winter Management,Snow & Winter Mgmt,Equipment,256222,170607,314265,833173,1574267
698,Other,Pensions,Pensions,Other Expenses,280602756,292088778,323684235,353855931,1250231700
699,Other,Debt Service,Debt Service,Other Expenses,638000,0,2092545,1454545,4185090
700,Other,Debt Service,Debt Service,Fixed Expenses,177345967,172304217,201593382,217543445,768787011
701,Other,Charter School Tuition,Charter School Tuition,Other Expenses,199702437,217698388,251621487,264549478,933571790
702,Other,MBTA,MBTA,Other Expenses,90665329,93345107,94117010,93613189,371740635
703,Other,Other State Assessments,Other State Assessments,Other Expenses,5526144,5331228,5509557,5555209,21922138
704,Other,Suffolk County Sheriff Dept,Suffolk County Sheriff Dept,Other Expenses,3845609,3845609,2898233,2898233,13487684
705,Other,Reserve,Reserve,Other Expenses,0,0,1131683,100000,1231683
706,Other,Annual Audit Costs,Annual Audit Costs,Other Expenses,1310973,142850,750000,750000,2953823
707,Other,Housing Trust Fund,Housing Trust Fund,Other Expenses,601009,576196,618000,618000,2413205
708,Other,Reserve for Collective Bargaining City,Reserve for Collective Bargaining City,Personnel Services,2200000,14000000,4805886,75393154,96399040
709,Other,OPEB,OPEB,Other Expenses,40000000,40000000,40000000,40000000,160000000
710,Other,Risk Retention Reserve,Risk Retention Reserve,Other Expenses,3000000,2500000,2500000,2500000,10500000
711,Other,Tax Title,Tax Title,Other Expenses,0,0,600000,600000,1200000
712,Streets,Transportation Department,Traffic Commissioner's Office,Personnel Services,968261,862629,894805,1028543,3754238
713,Streets,Transportation Department,Traffic Management & Engineering,Personnel Services,2310215,2124967,2269002,2387924,9092108
714,Streets,Transportation Department,Policy & Planning,Personnel Services,1384092,1654417,1975692,2721211,7735412
715,Streets,Transportation Department,Traffic Enforcement,Personnel Services,13971693,13671294,14919458,14755194,57317639
716,Streets,Transportation Department,Traffic Operations,Personnel Services,3939635,4023480,4287331,4222488,16472934
717,Streets,Transportation Department,Traffic Commissioner's Office,Contractual Services,166991,133069,103300,1112750,1516110
718,Streets,Transportation Department,Traffic Management & Engineering,Contractual Services,1747491,313427,284975,294975,2640868
719,Streets,Transportation Department,Policy & Planning,Contractual Services,112174,666830,1757722,889850,3426576
720,Streets,Transportation Department,Traffic Enforcement,Contractual Services,987849,557799,696970,711528,2954146
721,Streets,Transportation Department,Traffic Operations,Contractual Services,2375353,2495384,3357837,2768374,10996948
722,Streets,Transportation Department,Traffic Commissioner's Office,Supplies & Materials,34714,23481,40740,35600,134535
723,Streets,Transportation Department,Traffic Management & Engineering,Supplies & Materials,5000,4500,3750,3750,17000
724,Streets,Transportation Department,Policy & Planning,Supplies & Materials,0,1342,0,0,1342
725,Streets,Transportation Department,Traffic Enforcement,Supplies & Materials,337212,302472,305015,366818,1311517
726,Streets,Transportation Department,Traffic Operations,Supplies & Materials,1146707,1271330,1075086,1150110,4643233
727,Streets,Transportation Department,Traffic Commissioner's Office,Current Charges & Obligations,144202,100683,151015,152650,548550
728,Streets,Transportation Department,Traffic Management & Engineering,Current Charges & Obligations,24373,18624,40300,40300,123597
729,Streets,Transportation Department,Policy & Planning,Current Charges & Obligations,14414,13214,5000,5000,37628
730,Streets,Transportation Department,Traffic Enforcement,Current Charges & Obligations,196811,127067,171300,171300,666478
731,Streets,Transportation Department,Traffic Operations,Current Charges & Obligations,1646,5408,3705,3705,14464
732,Streets,Transportation Department,Traffic Commissioner's Office,Equipment,0,0,1200,1200,2400
733,Streets,Transportation Department,Traffic Management & Engineering,Equipment,167788,47740,50717,22820,289065
734,Streets,Transportation Department,Traffic Enforcement,Equipment,611980,638053,907235,866847,3024115
735,Streets,Transportation Department,Traffic Operations,Equipment,287351,284990,334001,431259,1337601
736,Streets,Transportation Department,Parking Clerk,Personnel Services,3021207,2995050,3221076,3219209,12456542
737,Streets,Transportation Department,Parking Clerk,Contractual Services,4633962,4728066,4755200,4508843,18626071
738,Streets,Transportation Department,Parking Clerk,Supplies & Materials,280820,254602,210000,214280,959702
739,Streets,Transportation Department,Parking Clerk,Current Charges & Obligations,2887,2366,2500,2001,9754
740,Streets,Transportation Department,Parking Clerk,Equipment,1108,14054,6000,6000,27162
741,Non-Mayoral Departments,City Clerk,Legislative Support,Personnel Services,481027,362193,397519,494562,1735301
742,Non-Mayoral Departments,City Clerk,Document Filing,Personnel Services,324444,485279,488545,508274,1806542
743,Non-Mayoral Departments,City Clerk,Archives,Personnel Services,401793,410579,426663,456148,1695183
744,Non-Mayoral Departments,City Clerk,Legislative Support,Contractual Services,14766,12099,16986,223482,267333
745,Non-Mayoral Departments,City Clerk,Document Filing,Contractual Services,3358,6826,10213,10653,31050
746,Non-Mayoral Departments,City Clerk,Archives,Contractual Services,53084,55592,67331,62274,238281
747,Non-Mayoral Departments,City Clerk,Legislative Support,Supplies & Materials,9993,5996,9699,8949,34637
748,Non-Mayoral Departments,City Clerk,Document Filing,Supplies & Materials,6294,10388,4300,6161,27143
749,Non-Mayoral Departments,City Clerk,Archives,Supplies & Materials,5219,651,5498,5498,16866
750,Non-Mayoral Departments,City Clerk,Legislative Support,Current Charges & Obligations,2388,0,4079,0,6467
751,Non-Mayoral Departments,City Clerk,Document Filing,Current Charges & Obligations,37,426,0,426,889
752,Non-Mayoral Departments,City Clerk,Archives,Current Charges & Obligations,1145,855,2050,2905,6955
753,Non-Mayoral Departments,City Clerk,Document Filing,Equipment,8394,0,0,0,8394
754,Non-Mayoral Departments,City Clerk,Archives,Equipment,0,13936,0,0,13936
755,Non-Mayoral Departments,City Council,City Council Administration,Personnel Services,280657,384477,371045,392330,1428509
756,Non-Mayoral Departments,City Council,City Councilors,Personnel Services,4477619,4412764,4899178,6173792,19963353
757,Non-Mayoral Departments,City Council,Legislative Financial Support,Personnel Services,551553,587979,549777,548877,2238186
758,Non-Mayoral Departments,City Council,City Council Administration,Contractual Services,29289,97576,56000,56000,238865
759,Non-Mayoral Departments,City Council,City Councilors,Contractual Services,104550,31244,145600,345600,626994
760,Non-Mayoral Departments,City Council,Legislative Financial Support,Contractual Services,1450,-200,5500,5500,12250
761,Non-Mayoral Departments,City Council,City Council Administration,Supplies & Materials,16845,11414,39000,39000,106259
762,Non-Mayoral Departments,City Council,City Councilors,Supplies & Materials,1050,1378,0,0,2428
763,Non-Mayoral Departments,City Council,Legislative Financial Support,Supplies & Materials,0,0,500,500,1000
764,Non-Mayoral Departments,City Council,City Council Administration,Current Charges & Obligations,0,2481,15100,15100,32681
765,Non-Mayoral Departments,City Council,City Councilors,Current Charges & Obligations,8814,5545,6000,6000,26359
766,Non-Mayoral Departments,City Council,Legislative Financial Support,Current Charges & Obligations,6679,6914,18200,18200,49993
767,Non-Mayoral Departments,City Council,City Council Administration,Equipment,0,0,0,57500,57500
768,Non-Mayoral Departments,City Council,City Councilors,Equipment,21808,23805,20500,20500,86613
769,Non-Mayoral Departments,City Council,Legislative Financial Support,Equipment,7816,23050,10000,10000,50866
770,Non-Mayoral Departments,Finance Commission,Finance Commission Program,Personnel Services,287327,291856,296825,313391,1189399
771,Non-Mayoral Departments,Finance Commission,Finance Commission Program,Contractual Services,2088,1608,4350,4350,12396
772,Non-Mayoral Departments,Finance Commission,Finance Commission Program,Supplies & Materials,63,25,525,525,1138
773,Non-Mayoral Departments,Finance Commission,Finance Commission Program,Current Charges & Obligations,35,0,250,250,535
774,Non-Mayoral Departments,Finance Commission,Finance Commission Program,Equipment,0,0,2125,2125,4250
